* ../scoreQuarantine/bach_bwv1007-01.score.xml	poly
* ../scoreQuarantine/bach_bwv1007-02.score.xml	poly
* ../scoreQuarantine/bach_bwv1007-03.score.xml	poly
* ../scoreQuarantine/bach_bwv1007-04.score.xml	poly
* ../scoreQuarantine/bach_bwv1007-05.score.xml	poly
* ../scoreQuarantine/bach_bwv1007-06.score.xml	poly
* ../scoreQuarantine/bach_bwv1007-07.score.xml	poly
* ../scoreQuarantine/bach_bwv1010-01.score.xml	poly
* ../scoreQuarantine/bach_bwv1010-02.score.xml	poly
* ../scoreQuarantine/bach_bwv1010-03.score.xml	ERROR
* ../scoreQuarantine/bach_bwv1010-04.score.xml	poly
* ../scoreQuarantine/bach_bwv1010-05.score.xml	poly
* ../scoreQuarantine/bach_bwv1010-06.score.xml	poly
* ../scoreQuarantine/bach_bwv1010-07.score.xml	poly
* ../scoreQuarantine/bach_bwv1011-03.score.xml	poly
* ../scoreQuarantine/bach_bwv978-1.score.xml	ERROR
* ../scoreQuarantine/bach_bwv978-2.score.xml	poly
* ../scoreQuarantine/bach_bwv978-3.score.xml	poly
* ../scoreQuarantine/bach_partita1-2.score.xml	poly
* ../scoreQuarantine/bach_partita1-3.score.xml	poly
* ../scoreQuarantine/bach_partita1-4.score.xml	poly
* ../scoreQuarantine/bach_partita1-6.score.xml	poly
* ../scoreQuarantine/bach_partita1-8.score.xml	poly
* ../scoreQuarantine/bach_partita2-1.score.xml	ERROR
* ../scoreQuarantine/bach_partita2-4.score.xml	poly
* ../scoreQuarantine/bach_partita3-6.score.xml	poly
* ../scoreQuarantine/bach_partita3-7.score.xml	poly
* ../scoreQuarantine/bach_sonata1-4.score.xml	poly
* ../scoreQuarantine/bach_sonata2-4.score.xml	poly
* ../scoreQuarantine/bach_sonata3-4.score.xml	poly
* ../scoreQuarantine/brahms_N6d.score.xml	poly
* ../scoreQuarantine/brahms_ballad10-1.score.xml	ERROR
* ../scoreQuarantine/brahms_brahms51-1-2.score.xml	ERROR
* ../scoreQuarantine/brahms_brahms51-1-3.score.xml	ERROR
* ../scoreQuarantine/brahms_op01-2.score.xml	ERROR
* ../scoreQuarantine/brahms_op39-01.score.xml	poly
* ../scoreQuarantine/brahms_op39-02-chord.score.xml	poly
* ../scoreQuarantine/brahms_op39-02.score.xml	poly
* ../scoreQuarantine/brahms_op39-08-chord.score.xml	poly
* ../scoreQuarantine/brahms_op39-08.score.xml	poly
* ../scoreQuarantine/brahms_op39-09.score.xml	ERROR
* ../scoreQuarantine/brahms_piston099.score.xml	poly
* ../scoreQuarantine/brahms_piston107.score.xml	poly
* ../scoreQuarantine/brahms_scherzo.score.xml	ERROR
* ../scoreQuarantine/chopin_N6e.score.xml	poly
* ../scoreQuarantine/chopin_ballade52.score.xml	ERROR
* ../scoreQuarantine/chopin_chopre20.score.xml	poly
* ../scoreQuarantine/chopin_etude10-02.score.xml	poly
* ../scoreQuarantine/chopin_etude10-02b.score.xml	poly
* ../scoreQuarantine/chopin_etude10-05.score.xml	ERROR
* ../scoreQuarantine/chopin_etude10-09.score.xml	ERROR
* ../scoreQuarantine/chopin_mazurka-50.score.xml	poly
* ../scoreQuarantine/chopin_mazurka-51.score.xml	ERROR
* ../scoreQuarantine/chopin_mazurka-52.score.xml	ERROR
* ../scoreQuarantine/chopin_mazurka06-1.score.xml	ERROR
* ../scoreQuarantine/chopin_mazurka06-2.score.xml	ERROR
* ../scoreQuarantine/chopin_mazurka06-3.score.xml	ERROR
* ../scoreQuarantine/chopin_mazurka06-4.score.xml	ERROR
* ../scoreQuarantine/chopin_mazurka07-1.score.xml	ERROR
* ../scoreQuarantine/chopin_mazurka07-2.score.xml	ERROR
* ../scoreQuarantine/chopin_mazurka07-3.score.xml	ERROR
* ../scoreQuarantine/chopin_mazurka07-4.score.xml	ERROR
* ../scoreQuarantine/chopin_mazurka07-5.score.xml	ERROR
* ../scoreQuarantine/chopin_mazurka17-1.score.xml	poly
* ../scoreQuarantine/chopin_mazurka17-2.score.xml	ERROR
* ../scoreQuarantine/chopin_mazurka17-3.score.xml	ERROR
* ../scoreQuarantine/chopin_mazurka17-4.score.xml	ERROR
* ../scoreQuarantine/chopin_mazurka24-1.score.xml	ERROR
* ../scoreQuarantine/chopin_mazurka24-2.score.xml	ERROR
* ../scoreQuarantine/chopin_mazurka24-3.score.xml	ERROR
* ../scoreQuarantine/chopin_mazurka24-4.score.xml	ERROR
* ../scoreQuarantine/chopin_mazurka30-1.score.xml	poly
* ../scoreQuarantine/chopin_mazurka30-2.score.xml	ERROR
* ../scoreQuarantine/chopin_mazurka30-3.score.xml	ERROR
* ../scoreQuarantine/chopin_mazurka30-4.score.xml	ERROR
* ../scoreQuarantine/chopin_mazurka33-1.score.xml	poly
* ../scoreQuarantine/chopin_mazurka33-2.score.xml	ERROR
* ../scoreQuarantine/chopin_mazurka33-3.score.xml	poly
* ../scoreQuarantine/chopin_mazurka33-4.score.xml	ERROR
* ../scoreQuarantine/chopin_mazurka41-1.score.xml	ERROR
* ../scoreQuarantine/chopin_mazurka41-2.score.xml	ERROR
* ../scoreQuarantine/chopin_mazurka41-3.score.xml	ERROR
* ../scoreQuarantine/chopin_mazurka41-4.score.xml	poly
* ../scoreQuarantine/chopin_mazurka50-1.score.xml	ERROR
* ../scoreQuarantine/chopin_mazurka50-2.score.xml	ERROR
* ../scoreQuarantine/chopin_mazurka50-3.score.xml	ERROR
* ../scoreQuarantine/chopin_mazurka56-1.score.xml	poly
* ../scoreQuarantine/chopin_mazurka56-2.score.xml	poly
* ../scoreQuarantine/chopin_mazurka56-3.score.xml	ERROR
* ../scoreQuarantine/chopin_mazurka59-1.score.xml	ERROR
* ../scoreQuarantine/chopin_mazurka59-2.score.xml	poly
* ../scoreQuarantine/chopin_mazurka59-3.score.xml	ERROR
* ../scoreQuarantine/chopin_mazurka63-1.score.xml	ERROR
* ../scoreQuarantine/chopin_mazurka63-2.score.xml	poly
* ../scoreQuarantine/chopin_mazurka63-3.score.xml	poly
* ../scoreQuarantine/chopin_mazurka67-1.score.xml	ERROR
* ../scoreQuarantine/chopin_mazurka67-2.score.xml	ERROR
* ../scoreQuarantine/chopin_mazurka67-3.score.xml	poly
* ../scoreQuarantine/chopin_mazurka67-4.score.xml	ERROR
* ../scoreQuarantine/chopin_mazurka68-1.score.xml	ERROR
* ../scoreQuarantine/chopin_mazurka68-2.score.xml	poly
* ../scoreQuarantine/chopin_mazurka68-3.score.xml	poly
* ../scoreQuarantine/chopin_mazurka68-4.score.xml	poly
* ../scoreQuarantine/chopin_nocturne72-1.score.xml	ERROR
* ../scoreQuarantine/chopin_piston070.score.xml	poly
* ../scoreQuarantine/chopin_piston106.score.xml	poly
* ../scoreQuarantine/chopin_piston174.score.xml	poly
* ../scoreQuarantine/chopin_prelude28-01.score.xml	ERROR
* ../scoreQuarantine/chopin_prelude28-02.score.xml	poly
* ../scoreQuarantine/chopin_prelude28-03.score.xml	ERROR
* ../scoreQuarantine/chopin_prelude28-04.score.xml	ERROR
* ../scoreQuarantine/chopin_prelude28-05.score.xml	poly
* ../scoreQuarantine/chopin_prelude28-06.score.xml	ERROR
* ../scoreQuarantine/chopin_prelude28-07.score.xml	poly
* ../scoreQuarantine/chopin_prelude28-08.score.xml	poly
* ../scoreQuarantine/chopin_prelude28-09.score.xml	ERROR
* ../scoreQuarantine/chopin_prelude28-10.score.xml	ERROR
* ../scoreQuarantine/chopin_prelude28-11.score.xml	poly
* ../scoreQuarantine/chopin_prelude28-12.score.xml	poly
* ../scoreQuarantine/chopin_prelude28-13.score.xml	ERROR
* ../scoreQuarantine/chopin_prelude28-14.score.xml	ERROR
* ../scoreQuarantine/chopin_prelude28-15.score.xml	ERROR
* ../scoreQuarantine/chopin_prelude28-16.score.xml	ERROR
* ../scoreQuarantine/chopin_prelude28-17.score.xml	poly
* ../scoreQuarantine/chopin_prelude28-18.score.xml	ERROR
* ../scoreQuarantine/chopin_prelude28-19.score.xml	ERROR
* ../scoreQuarantine/chopin_prelude28-20.score.xml	poly
* ../scoreQuarantine/chopin_prelude28-21.score.xml	poly
* ../scoreQuarantine/chopin_prelude28-22.score.xml	poly
* ../scoreQuarantine/chopin_prelude28-23.score.xml	poly
* ../scoreQuarantine/chopin_prelude28-24.score.xml	poly
* ../scoreQuarantine/chopin_scherzo2.score.xml	ERROR
* ../scoreQuarantine/chopin_waltz150.score.xml	ERROR
* ../scoreQuarantine/chopin_waltz64-1.score.xml	ERROR
* ../scoreQuarantine/chopin_waltz64-2.score.xml	ERROR
* ../scoreQuarantine/chopin_waltz69-2.score.xml	poly
* ../scoreQuarantine/clementi_sonatina-36-1-1.score.xml	poly
* ../scoreQuarantine/clementi_sonatina-36-1-2.score.xml	ERROR
* ../scoreQuarantine/clementi_sonatina-36-1-3.score.xml	poly
* ../scoreQuarantine/clementi_sonatina-36-2-1.score.xml	poly
* ../scoreQuarantine/clementi_sonatina-36-2-2.score.xml	poly
* ../scoreQuarantine/clementi_sonatina-36-2-3.score.xml	poly
* ../scoreQuarantine/clementi_sonatina-36-3-1.score.xml	poly
* ../scoreQuarantine/clementi_sonatina-36-3-2.score.xml	poly
* ../scoreQuarantine/clementi_sonatina-36-3-3.score.xml	poly
* ../scoreQuarantine/clementi_sonatina-36-4-1.score.xml	poly
* ../scoreQuarantine/clementi_sonatina-36-4-2.score.xml	poly
* ../scoreQuarantine/clementi_sonatina-36-4-3.score.xml	ERROR
* ../scoreQuarantine/clementi_sonatina-36-5-1.score.xml	ERROR
* ../scoreQuarantine/clementi_sonatina-36-5-2.score.xml	poly
* ../scoreQuarantine/clementi_sonatina-36-5-3.score.xml	poly
* ../scoreQuarantine/clementi_sonatina-36-6-1.score.xml	poly
* ../scoreQuarantine/clementi_sonatina-36-6-2.score.xml	poly
* ../scoreQuarantine/gershwin_bwv1007-01.score.xml	poly
* ../scoreQuarantine/gershwin_gersh01.score.xml	poly
* ../scoreQuarantine/gershwin_gersh03.score.xml	poly
* ../scoreQuarantine/gershwin_gersh04.score.xml	ERROR
* ../scoreQuarantine/gershwin_gersh05.score.xml	poly
* ../scoreQuarantine/gershwin_gersh06.score.xml	poly
* ../scoreQuarantine/gershwin_gersh07.score.xml	poly
* ../scoreQuarantine/gershwin_gersh08.score.xml	poly
* ../scoreQuarantine/gershwin_gersh09.score.xml	poly
* ../scoreQuarantine/gershwin_gersh10.score.xml	poly
* ../scoreQuarantine/gershwin_gersh11.score.xml	poly
* ../scoreQuarantine/gershwin_gersh12.score.xml	poly
* ../scoreQuarantine/gershwin_gersh14.score.xml	poly
* ../scoreQuarantine/gershwin_gersh15.score.xml	poly
* ../scoreQuarantine/gershwin_gersh16.score.xml	ERROR
* ../scoreQuarantine/gershwin_gersh17.score.xml	poly
* ../scoreQuarantine/gershwin_gersh18.score.xml	ERROR
* ../scoreQuarantine/gershwin_gersh19.score.xml	poly
* ../scoreQuarantine/gershwin_gersh20.score.xml	poly
* ../scoreQuarantine/gershwin_gersh21.score.xml	poly
* ../scoreQuarantine/gershwin_gersh22.score.xml	ERROR
* ../scoreQuarantine/gershwin_gersh23.score.xml	ERROR
* ../scoreQuarantine/gershwin_gersh24.score.xml	poly
* ../scoreQuarantine/gershwin_gersh25.score.xml	poly
* ../scoreQuarantine/gershwin_gersh26.score.xml	poly
* ../scoreQuarantine/gershwin_gersh27.score.xml	poly
* ../scoreQuarantine/gershwin_gersh28.score.xml	ERROR
* ../scoreQuarantine/gershwin_gersh30.score.xml	ERROR
* ../scoreQuarantine/grieg_butterfly.score.xml	poly
* ../scoreQuarantine/grieg_erotic-poem.score.xml	ERROR
* ../scoreQuarantine/grieg_little-bird.score.xml	ERROR
* ../scoreQuarantine/grieg_native-country.score.xml	poly
* ../scoreQuarantine/grieg_op01-3.score.xml	ERROR
* ../scoreQuarantine/grieg_op03-4.score.xml	ERROR
* ../scoreQuarantine/grieg_op06-3.score.xml	ERROR
* ../scoreQuarantine/grieg_op07-1.score.xml	ERROR
* ../scoreQuarantine/grieg_op12-2.score.xml	ERROR
* ../scoreQuarantine/grieg_op46-1.score.xml	poly
* ../scoreQuarantine/grieg_op46-3.score.xml	poly
* ../scoreQuarantine/grieg_op46-4.score.xml	poly
* ../scoreQuarantine/grieg_op66-06.score.xml	poly
* ../scoreQuarantine/grieg_solitary-traveller.score.xml	ERROR
* ../scoreQuarantine/mozart_k439b.score.xml	poly
* ../scoreQuarantine/mozart_sonata01-1.score.xml	poly
* ../scoreQuarantine/mozart_sonata01-2.score.xml	ERROR
* ../scoreQuarantine/mozart_sonata01-3.score.xml	poly
* ../scoreQuarantine/mozart_sonata02-1.score.xml	ERROR
* ../scoreQuarantine/mozart_sonata02-2.score.xml	poly
* ../scoreQuarantine/mozart_sonata02-3.score.xml	poly
* ../scoreQuarantine/mozart_sonata03-1.score.xml	ERROR
* ../scoreQuarantine/mozart_sonata03-2.score.xml	ERROR
* ../scoreQuarantine/mozart_sonata03-3.score.xml	ERROR
* ../scoreQuarantine/mozart_sonata04-1.score.xml	ERROR
* ../scoreQuarantine/mozart_sonata04-2.score.xml	ERROR
* ../scoreQuarantine/mozart_sonata04-3.score.xml	poly
* ../scoreQuarantine/mozart_sonata05-1.score.xml	ERROR
* ../scoreQuarantine/mozart_sonata05-2.score.xml	poly
* ../scoreQuarantine/mozart_sonata05-3.score.xml	poly
* ../scoreQuarantine/mozart_sonata06-1.score.xml	poly
* ../scoreQuarantine/mozart_sonata06-2.score.xml	ERROR
* ../scoreQuarantine/mozart_sonata06-3a.score.xml	poly
* ../scoreQuarantine/mozart_sonata06-3b.score.xml	ERROR
* ../scoreQuarantine/mozart_sonata06-3c.score.xml	ERROR
* ../scoreQuarantine/mozart_sonata06-3d.score.xml	poly
* ../scoreQuarantine/mozart_sonata06-3e.score.xml	poly
* ../scoreQuarantine/mozart_sonata06-3f.score.xml	poly
* ../scoreQuarantine/mozart_sonata06-3g.score.xml	poly
* ../scoreQuarantine/mozart_sonata06-3h.score.xml	poly
* ../scoreQuarantine/mozart_sonata06-3i.score.xml	poly
* ../scoreQuarantine/mozart_sonata06-3j.score.xml	poly
* ../scoreQuarantine/mozart_sonata06-3k.score.xml	poly
* ../scoreQuarantine/mozart_sonata06-3l.score.xml	ERROR
* ../scoreQuarantine/mozart_sonata06-3m.score.xml	poly
* ../scoreQuarantine/mozart_sonata07-1.score.xml	poly
* ../scoreQuarantine/mozart_sonata07-2.score.xml	ERROR
* ../scoreQuarantine/mozart_sonata07-3.score.xml	ERROR
* ../scoreQuarantine/mozart_sonata08-1.score.xml	poly
* ../scoreQuarantine/mozart_sonata08-2.score.xml	ERROR
* ../scoreQuarantine/mozart_sonata08-3.score.xml	poly
* ../scoreQuarantine/mozart_sonata09-1.score.xml	ERROR
* ../scoreQuarantine/mozart_sonata09-2.score.xml	ERROR
* ../scoreQuarantine/mozart_sonata09-3.score.xml	ERROR
* ../scoreQuarantine/mozart_sonata10-1.score.xml	ERROR
* ../scoreQuarantine/mozart_sonata10-2.score.xml	poly
* ../scoreQuarantine/mozart_sonata10-3.score.xml	ERROR
* ../scoreQuarantine/mozart_sonata11-1a.score.xml	poly
* ../scoreQuarantine/mozart_sonata11-1b.score.xml	poly
* ../scoreQuarantine/mozart_sonata11-1c.score.xml	ERROR
* ../scoreQuarantine/mozart_sonata11-1d.score.xml	poly
* ../scoreQuarantine/mozart_sonata11-1e.score.xml	poly
* ../scoreQuarantine/mozart_sonata11-1f.score.xml	ERROR
* ../scoreQuarantine/mozart_sonata11-1g.score.xml	poly
* ../scoreQuarantine/mozart_sonata11-2.score.xml	poly
* ../scoreQuarantine/mozart_sonata11-3.score.xml	poly
* ../scoreQuarantine/mozart_sonata12-1.score.xml	poly
* ../scoreQuarantine/mozart_sonata12-2.score.xml	ERROR
* ../scoreQuarantine/mozart_sonata12-3.score.xml	poly
* ../scoreQuarantine/mozart_sonata13-1.score.xml	poly
* ../scoreQuarantine/mozart_sonata13-2.score.xml	ERROR
* ../scoreQuarantine/mozart_sonata13-3.score.xml	ERROR
* ../scoreQuarantine/mozart_sonata14-1.score.xml	ERROR
* ../scoreQuarantine/mozart_sonata14-2.score.xml	ERROR
* ../scoreQuarantine/mozart_sonata14-3.score.xml	ERROR
* ../scoreQuarantine/mozart_sonata15-1.score.xml	poly
* ../scoreQuarantine/mozart_sonata15-2.score.xml	poly
* ../scoreQuarantine/mozart_sonata15-3.score.xml	poly
* ../scoreQuarantine/mozart_sonata16-1.score.xml	poly
* ../scoreQuarantine/mozart_sonata16-2.score.xml	ERROR
* ../scoreQuarantine/mozart_sonata16-3.score.xml	poly
* ../scoreQuarantine/mozart_sonata17-1.score.xml	poly
* ../scoreQuarantine/mozart_sonata17-2.score.xml	poly
* ../scoreQuarantine/mozart_sonata17-3.score.xml	ERROR
* ../scoreQuarantine/mozart_viennese1-1.score.xml	poly
* ../scoreQuarantine/mozart_viennese1-2.score.xml	ERROR
* ../scoreQuarantine/mozart_viennese1-3.score.xml	ERROR
* ../scoreQuarantine/mozart_viennese1-4.score.xml	poly
* ../scoreQuarantine/mozart_viennese6-1.score.xml	poly
* ../scoreQuarantine/mozart_viennese6-2.score.xml	poly
* ../scoreQuarantine/mozart_viennese6-3.score.xml	poly
* ../scoreQuarantine/mozart_viennese6-4.score.xml	poly
* ../scoreQuarantine/schubert_N6c.score.xml	ERROR
* ../scoreQuarantine/schubert_d0576-00.score.xml	poly
* ../scoreQuarantine/schubert_d0576-01.score.xml	poly
* ../scoreQuarantine/schubert_d0576-02.score.xml	poly
* ../scoreQuarantine/schubert_d0576-03.score.xml	poly
* ../scoreQuarantine/schubert_d0576-04.score.xml	poly
* ../scoreQuarantine/schubert_d0576-05.score.xml	ERROR
* ../scoreQuarantine/schubert_d0576-06.score.xml	poly
* ../scoreQuarantine/schubert_d0576-07.score.xml	poly
* ../scoreQuarantine/schubert_d0576-08.score.xml	poly
* ../scoreQuarantine/schubert_d0576-09.score.xml	poly
* ../scoreQuarantine/schubert_d0576-10.score.xml	poly
* ../scoreQuarantine/schubert_d0576-11.score.xml	poly
* ../scoreQuarantine/schubert_d0576-12.score.xml	poly
* ../scoreQuarantine/schubert_d0576-13.score.xml	poly
* ../scoreQuarantine/schubert_erk205.score.xml	ERROR
* ../scoreQuarantine/schubert_hydraulicus.score.xml	poly
* ../scoreQuarantine/schubert_op90-03.score.xml	ERROR
* ../scoreQuarantine/schubert_piston293.score.xml	poly
* ../scoreQuarantine/schubert_quartet10-1.score.xml	ERROR
* ../scoreQuarantine/schubert_quartet10-2.score.xml	poly
* ../scoreQuarantine/schubert_quartet10-3.score.xml	poly
* ../scoreQuarantine/schubert_quartet10-4.score.xml	ERROR
* ../scoreQuarantine/schubert_raw.score.xml	poly
* ../scoreQuarantine/schubert_schub01.score.xml	poly
* ../scoreQuarantine/schubert_schub02.score.xml	poly
* ../scoreQuarantine/schubert_schub03.score.xml	ERROR
* ../scoreQuarantine/schubert_schub04.score.xml	poly
* ../scoreQuarantine/schubert_schub05.score.xml	poly
* ../scoreQuarantine/schubert_schub06.score.xml	ERROR
* ../scoreQuarantine/schubert_schub07.score.xml	poly
* ../scoreQuarantine/schubert_schub08.score.xml	poly
* ../scoreQuarantine/schubert_schub09.score.xml	poly
* ../scoreQuarantine/schubert_schub10.score.xml	poly
* ../scoreQuarantine/schubert_schub11.score.xml	poly
* ../scoreQuarantine/schubert_schub12.score.xml	ERROR
* ../scoreQuarantine/schubert_schub13.score.xml	poly
* ../scoreQuarantine/schubert_schub14.score.xml	poly
* ../scoreQuarantine/schubert_schub15.score.xml	poly
* ../scoreQuarantine/schubert_schub16.score.xml	poly
* ../scoreQuarantine/schubert_schub17.score.xml	poly
* ../scoreQuarantine/schubert_schub18.score.xml	poly
* ../scoreQuarantine/schubert_schub19.score.xml	poly
* ../scoreQuarantine/schubert_schub20.score.xml	poly
* ../scoreQuarantine/schubert_schub21.score.xml	poly
* ../scoreQuarantine/schubert_schub22.score.xml	poly
* ../scoreQuarantine/schubert_schub23.score.xml	poly
* ../scoreQuarantine/schubert_schub24.score.xml	poly
* ../scoreQuarantine/schubert_schub25.score.xml	poly
* ../scoreQuarantine/schubert_schub26.score.xml	poly
* ../scoreQuarantine/schubert_schub27.score.xml	poly
* ../scoreQuarantine/schubert_schub28.score.xml	poly
* ../scoreQuarantine/schubert_schub29.score.xml	poly
* ../scoreQuarantine/schubert_schub30.score.xml	poly
* ../scoreQuarantine/schubert_schub31.score.xml	poly
* ../scoreQuarantine/schubert_schub32.score.xml	poly
* ../scoreQuarantine/schubert_schub33.score.xml	poly
* ../scoreQuarantine/schubert_schub34.score.xml	poly
* ../scoreQuarantine/schubert_schub35.score.xml	poly
* ../scoreQuarantine/schubert_tmte04-63h.score.xml	poly
* ../scoreQuarantine/schubert_tmte04-63j.score.xml	poly
* ../scoreQuarantine/schubert_trio.score.xml	ERROR
* ../scoreQuarantine/schumann_op35-no03.score.xml	poly
* ../scoreQuarantine/schumann_op68no01-chord.score.xml	poly
* ../scoreQuarantine/schumann_op68no01.score.xml	poly
* ../scoreQuarantine/schumann_op68no10-chord.score.xml	poly
* ../scoreQuarantine/schumann_op68no10.score.xml	poly
* ../scoreQuarantine/schumann_piston102.score.xml	poly
* ../scoreQuarantine/schumann_piston291.score.xml	poly
* ../scoreQuarantine/schumann_schumann-97-4-1.score.xml	poly
* ../scoreQuarantine/schumann_tmte04-63d.score.xml	poly
* ../scoreQuarantine/schumann_tmte04-63m.score.xml	poly
* ../scoreQuarantine/schumann_tmte04-63r.score.xml	poly
